####### #  ##### #### ######
#    ################## #  #
# #### ###         #### #  #
#                    # # # #
# # ########B ####### ###  #
#   #####     ##### ########
######      ####      ######
#    ####   ######    ######
###   ####   ########   ####
###               ##########
##########   #####   #######
###########  ######  #######
########    ###  ##  #   ###
#####      #################
A      ####  ###############