########B##
##### #####
####  #####
# #########
      #####
A##########      